XXXXXXXXXXXXXXXXXXXXXXXXXXXXXXXXXXXXXSX
XXXX                                  X
XXXX XXXXXXXXXXXXXXXXXXXXXXXXXXXXXXXX X
XX              XX                    X
XXXXXXXX XXXXXX XXXXXXXXXXXXXXXXXXXXX X
X         X           XXX       X XXX X
XXXXXXXXXXXXXXXXXXXXX XXX XXXXXXX XXX X
X                           XX    X   X
X XXXXXXX XXXXXXXXXXXXXXXXX XXXXX X X X
X X       X        XXXXXXXX XXXXX X X X
X XXXXX XXX XXX XXXXXXXXXXX       X X X
X X     XXX XXX       XXXXXXXXX XX  X X
X XXXXX        XXXXXXXXX        XX XX X
XXXXXXXXXXXXXXXXXXXXXXXXXXXXXXXXX  XX X
XXX                               XXX X
XXXXXXXXXXXXXX XXXXXXXXXXXXXXXXXXXXXX X
X      XXXXXXX XXXXXXXXXXXXXXX        X
X XX XX                      XXXXXXXXXX
E XX XXX XXXXXXXX XXXXXXXXXXXXXXXX   XX
X XX     XXX                       X  X
XXXXXXXXXXXXXXXXXXXXXXXXXXXXXXXXXXXXXXX