XXXXXXXXXXXXXXXXXXXX
XX                 X
XX XXXXXXXXXXX X X X
X  X     XXXXX X X X
XX X X X     X X XXX
XX X X X XXXXX X   X
XX XXX X X     XX XX
X      X X XXXXXX XX
XXXXXXXX X   X     X
S        XXXXXXXX XX
XXXXXXXXXX         X
XX       XXXXXX XXXX
XXXXXXX         XXXX
XXX  XXXXXXX XXXXXXX
XX               XXX
XXXXXXXXXXXXXX XXXXX
X            X   X X
X XX XX XXXXXX XXX X
X  X X             X
XXXX XXX XXXXXXXXXXX
XX    X            X
XXXXXXXXXXXXXXXEXXXX