XXXXXXXXXXXXXXXXXXEX
XX                 X
XX XXXXXXXXXXX X X X
X  X     XXXXX X X X
XX X X X     X X XXX
XX X X X XXXXX X   X
XX XXX X X     XX XX
X      X X XXXXXX XX
XXXXXXXX X   X     X
X        XXXXXXXX XX
XXXXXXXXXX         X
XX       XXXXXX XX X
XXXXXXX         XX S
XXX  XXXXXXX XXXXX X
XX               X X
XXXXXXXXXXXXXXXXXXXX
